アーモンド	A[h h{
アイ	DAC
アオカズラ	AIJY ̔
アオキ	AIL X
アオギリ	AIM w|w
アオジソ	AIW\ ĕ
アオツヅラフジ	AIcdtW Ő
アオダモ	AI_ ĕ
アオ	tJC AI g
マムシグサ	}VOT̒
アカザ	AJU
アカジソ	AJW\ Vs
アカツメクサ	AJcNT Ԍt
アカマツ	ЃWI AJ}c
アカメガシワ	AJKV
アカモノ	cKUN
アカバナ	Ԋۖ{ AJoi
サンザシ	TUV\
アカバナマンサク	AJoi}TNԌt
アカバナムシヨケギク	AJoiVPMN ĕ
アカヤシオ	UێRAJVI
アカヤジオウ	AJWIE c
アキカラマツ	J}c\E
アキギリ	LoiALM
アキグミ	ALO~ ĕ
アキノキリンソウ	ZC^JA_`\E
アキノノゲシ	z\oALmmQV
アクシバ	ANVo Uh
アケビ	APr ĕ
アケボノ	AP{m
アセビ	AZr ĕ
アサガオ	̃ATKI
アサクラザンショウ	ATNUVE c
アサツキ	ATcL ͔|
アサマリンドウ	AT}hE ĕ
アザミ	AU~
アザレア	AUAĕ
アシ	AV V
アジサイ	AWTC ĕ
アシタバ	AV^o ͔|
アズキ	AYL
アズマイチゲ	AY}C`Q LNULC`Q
アズマギク	AY}MN Ԍt
アズマシロカネソウ	AY}VJl\E ΐ쌧
アスパラガス	AXpKX Vs
アセビ	AZr ĕ
アッサムチャ	AbT AbT
アブラチャン	Au` ĕ
アブラナ	Aui 
アベマキ	NkM
アマ	A}A
アマチャ	A}` c
アマチャヅル	A}`d \
アマドコロ	A}hR Hו
アマナ	A}i ̗p
アマナツ	A}ic _
